8,4,8,4,4,4,2,4,4,7,4,2,2,4,4,4,4,1,1,4
4,4,7,1,6,4,2,1,4,2,1,4,4,4,5,4,1,2,1,4
4,4,2,2,1,4,5,2,2,2,5,2,1,4,4,2,2,2,2,2
2,2,6,2,4,2,2,2,4,2,2,2,2,1,2,4,1,4,1,4
4,1,5,4,2,1,2,1,7,1,1,4,7,1,2,5,1,2,1,1
8,4,4,2,1,4,2,2,2,2,2,2,1,2,2,1,2,2,2,2
8,4,4,4,2,2,5,2,2,2,4,1,2,5,5,2,2,2,4,4
0,0,0,0,0,0,0,0,0,0,0,0,0,0,0,0,0,0,0,0
0,0,0,0,0,0,0,0,0,0,0,0,0,0,0,0,0,0,0,0
0,0,0,0,0,0,0,0,0,0,0,0,0,0,0,0,0,0,0,0
